TILEMAP
208 15   							-- Size of tile map in tiles
32 32							-- Tile size & block size
images/test.png 					-- Tilesheet
16 16						-- Number of tiles in tilesheet
29 29 29 29 29 29 29 29 29 29 29 29 29 29 29 29 29 29 29 29 29 29 29 29 29 29 29 29 29 29 29 29 29 29 29 29 29 29 29 29 29 29 29 29 29 29 29 29 29 29 29 29 29 31 29 29 29 29 29 29 29 29 29 29 29 29 29 29 29 29 29 31 29 29 29 29 29 29 29 29 29 29 29 29 29 29 29 29 29 29 29 29 29 29 29 29 29 29 29 29 29 29 29 29 29 29 29 29 29 29 29 29 29 29 29 29 29 29 29 29 29 29 29 29 29 29 29 29 29 29 29 29 29 29 29 29 29 29 29 29 29 29 29 29 29 29 29 29 29 29 29 29 29 29 29 29 29 29 29 29 29 29 29 29 29 29 29 29 29 29 29 29 29 29 29 29 29 29 29 29 29 29 29 29 29 29 29 29 29 29 29 29 29 29 29 29 29 29 29 29 29 29 29 29 29 29 29 29
30 32 30 31 30 30 31 31 30 32 29 31 30 32 29 29 29 32 31 32 31 32 30 30 29 31 30 29 31 31 30 29 31 31 30 29 31 31 30 29 29 31 32 30 30 29 30 32 29 29 29 29 29 29 32 29 29 29 29 29 29 29 29 29 29 29 29 29 29 29 29 29 32 29 29 29 29 29 31 31 30 32 29 29 50 51 39 51 39 51 39 51 39 51 39 51 39 51 39 51 39 51 39 51 39 51 39 51 39 51 39 51 39 51 39 51 39 51 39 51 39 51 39 51 39 51 39 51 39 51 39 51 39 51 39 51 39 51 39 51 39 51 39 51 39 51 39 51 39 51 39 51 39 51 39 51 39 51 39 51 39 51 39 51 39 51 39 51 39 51 39 51 39 51 39 51 39 51 39 51 39 51 39 51 39 51 39 51 39 51 39 51 39 51 39 51 39 38 44 29 29 29 29 29 29 29 29 29
31 33 31 30 31 33 29 11 14 18 23 11 14 18 23 30 29 31 33 31 30 11 14 18 23 11 14 18 23 11 14 18 23 11 14 18 23 11 14 18 23 29 29 31 31 32 31 29 29 29 29 29 31 29 29 31 29 29 29 29 29 29 29 29 29 29 29 29 29 29 31 29 29 31 29 29 29 29 29 11 14 18 23 29 52 53 52 53 52 53 52 53 52 53 52 53 52 53 52 53 52 53 52 53 52 53 52 53 52 53 52 53 52 53 52 53 52 53 52 53 52 53 52 53 52 53 52 53 52 53 52 53 52 53 52 53 52 53 52 53 52 53 52 53 52 53 52 53 52 53 52 53 52 53 52 53 52 53 52 53 52 35 52 35 52 35 52 35 52 35 52 35 52 35 52 35 52 35 52 35 52 35 52 35 52 35 52 35 52 35 52 35 52 35 52 35 35 35 45 29 29 29 29 29 29 29 29 29
30 31 29 29 29 29 9 12 15 19 22 12 15 19 24 31 29 29 29 29 9 12 15 19 22 12 15 19 22 12 15 19 22 12 15 19 22 12 15 19 24 29 29 29 29 31 29 29 29 29 29 29 29 30 29 29 29 29 29 29 29 29 29 29 29 29 29 29 29 29 29 30 29 29 29 29 29 29 9 12 15 19 24 29 54 55 54 55 54 55 54 55 54 55 54 55 54 55 54 55 54 55 54 55 54 55 54 55 54 55 54 55 54 55 54 55 54 55 54 55 54 55 54 55 54 55 54 55 54 55 54 55 54 55 54 55 54 55 54 55 54 55 54 55 54 55 54 55 54 55 54 55 54 55 56 57 56 57 54 55 49 51 39 51 39 51 39 51 39 51 39 51 39 51 39 51 39 51 39 51 39 51 39 51 39 51 39 51 39 51 39 51 39 51 39 51 39 51 46 48 29 58 59 60 61 62 62 62
31 30 29 29 29 29 10 13 16 20 10 13 16 20 29 29 29 29 29 29 10 13 16 20 10 13 16 20 10 13 16 20 10 13 16 20 10 13 16 20 29 29 29 29 29 29 29 29 29 29 29 29 29 29 31 32 29 29 29 29 29 29 29 29 29 29 29 29 29 29 29 29 31 32 29 29 29 29 10 13 16 20 29 29 56 57 56 57 56 57 56 57 56 57 56 57 56 57 56 57 56 57 56 57 56 57 56 57 56 57 56 57 56 57 56 57 54 55 54 55 54 55 54 55 54 55 56 57 56 57 56 57 56 57 56 57 54 55 54 55 54 55 54 55 54 55 54 55 54 55 54 55 54 55 112 113 112 113 54 55 40 53 52 53 52 53 52 53 52 53 52 53 52 53 52 53 52 53 52 53 52 53 52 53 52 53 52 53 52 53 52 53 52 53 52 53 52 53 52 49 29 63 64 65 66 67 67 67
29 29 120 121 121 121 121 125 120 121 121 125 120 121 120 121 121 121 121 121 121 121 121 125 120 121 121 121 121 120 120 125 120 125 121 121 121 121 121 121 125 121 121 121 121 121 121 125 29 29 29 29 29 29 29 29 120 121 121 121 121 121 121 121 121 125 29 29 29 29 29 29 29 29 120 121 121 121 121 121 121 121 121 121 112 113 112 113 112 113 112 113 112 113 112 113 112 113 112 113 112 113 112 113 112 113 112 113 112 113 112 113 112 113 112 113 54 55 54 55 54 55 54 55 54 55 112 113 112 113 112 113 112 113 112 113 54 55 54 55 54 55 54 55 54 55 54 55 54 55 54 55 56 57 108 105 108 105 54 55 54 55 54 55 54 55 54 55 54 55 54 55 54 55 54 55 54 55 54 55 54 55 54 55 54 55 54 55 54 55 54 55 54 55 54 55 54 55 54 55 29 68 69 70 66 103 103 103
29 29 114 115 115 117 117 119 114 115 114 114 114 115 114 115 115 115 115 114 115 115 115 115 114 115 115 115 115 114 114 115 115 114 114 115 115 115 115 115 114 115 114 115 114 115 115 115 29 29 29 29 29 29 29 29 115 114 114 114 114 114 114 114 114 114 29 29 29 29 29 29 29 29 115 114 114 114 114 114 114 114 114 114 104 105 104 105 104 105 104 105 104 105 104 105 104 105 104 105 104 105 104 105 104 105 104 105 104 105 104 105 104 105 104 105 56 57 56 57 56 57 56 57 56 57 108 105 108 105 108 105 108 105 108 105 54 55 56 57 56 57 54 55 54 55 54 55 54 55 54 55 112 113 112 113 106 107 54 55 56 57 56 57 54 55 54 55 54 55 54 55 54 55 54 55 54 55 54 55 54 55 54 55 54 55 56 57 56 57 56 57 56 57 54 55 54 55 54 55 29 72 73 74 66 103 103 103
29 29 112 113 112 113 112 113 112 113 112 113 112 113 112 113 112 113 112 113 112 113 112 113 112 113 112 113 112 113 112 113 112 113 112 113 112 113 112 113 112 113 112 113 112 113 112 113 7 29 29 29 7 8 7 8 112 113 112 113 112 113 112 113 112 113 7 8 7 8 7 8 7 8 112 113 112 113 112 113 112 113 112 113 112 113 112 113 106 107 106 107 106 107 106 107 106 107 106 107 106 107 106 107 106 107 106 107 106 107 106 107 106 107 112 113 112 113 112 113 112 113 112 113 112 113 112 113 106 107 106 107 106 107 106 107 54 55 112 113 112 113 54 55 54 55 54 55 54 55 54 55 108 105 108 105 108 105 54 55 112 113 112 113 54 55 54 55 54 55 54 55 54 55 54 55 54 55 54 55 54 55 54 55 54 55 112 113 112 113 112 113 112 113 54 55 54 55 54 55 29 76 77 78 66 103 103 103
29 29 104 105 104 105 104 105 104 105 104 105 104 105 104 105 104 105 104 105 104 105 104 105 104 105 104 105 104 105 104 105 104 105 104 105 104 105 104 105 104 105 104 105 104 105 104 105 4 29 29 29 5 5 5 6 104 105 104 105 104 105 104 105 104 105 4 5 5 5 5 5 5 6 104 105 104 105 104 105 104 105 104 105 104 105 104 105 108 105 108 105 108 105 108 105 108 105 108 105 108 105 108 105 108 105 108 105 108 105 108 105 108 105 108 105 108 105 108 105 108 105 108 105 108 105 108 105 108 105 108 105 108 105 108 105 56 57 108 105 108 105 54 55 56 57 56 57 54 55 54 55 106 107 106 107 106 107 54 55 106 107 106 107 56 57 56 57 56 57 56 57 54 55 54 55 54 55 54 55 54 55 56 57 56 57 106 107 106 107 106 107 104 105 56 57 54 55 54 55 29 80 81 82 66 103 103 103
1 1 106 107 106 107 106 107 106 107 112 113 112 113 112 113 106 107 106 107 106 107 106 107 106 107 112 113 112 113 106 107 106 107 106 107 106 107 106 107 106 107 106 107 106 107 106 107 1 1 1 1 1 1 1 1 106 107 106 107 106 107 106 107 106 107 1 1 1 1 1 1 1 1 106 107 106 107 106 107 106 107 106 107 106 107 106 107 106 107 106 107 106 107 106 107 106 107 112 113 112 113 112 113 112 113 112 113 112 113 112 113 106 107 106 107 106 107 106 107 106 107 106 107 106 107 106 107 106 107 106 107 106 107 112 113 112 113 112 113 106 107 54 55 112 113 112 113 54 55 54 55 108 105 108 105 108 105 54 55 108 105 112 113 112 113 112 113 112 113 112 113 54 55 54 55 54 55 54 55 54 55 112 113 112 113 108 105 108 105 106 107 106 107 112 113 54 55 54 55 29 84 85 86 100 128 128 128
1 1 108 105 108 105 108 105 108 105 104 105 104 105 104 105 108 105 108 105 108 105 108 105 108 105 104 105 104 105 108 105 108 105 108 105 108 105 108 105 112 113 112 113 112 113 108 105 1 1 1 1 1 1 1 1 108 105 108 105 108 105 108 105 108 105 1 1 1 1 1 1 1 1 108 105 108 105 108 105 108 105 108 105 108 105 108 105 108 105 108 105 112 113 112 113 112 113 104 105 104 105 104 105 104 105 104 105 104 105 104 105 108 105 108 105 108 105 108 105 108 105 108 105 108 105 108 105 108 105 112 113 108 105 108 105 108 105 108 105 108 105 54 55 108 105 108 105 56 57 56 57 106 107 106 107 112 113 54 55 106 107 106 107 106 107 106 107 106 107 106 107 54 55 54 55 56 57 56 57 54 55 106 107 106 107 106 107 112 113 112 113 112 113 104 105 56 57 56 57 29 88 89 90 66 103 103 103
1 2 106 107 106 107 106 107 106 107 106 107 106 107 106 107 112 113 106 107 106 107 112 113 106 107 106 107 106 107 106 107 106 107 106 107 106 107 106 107 106 107 106 107 106 107 106 107 1 1 1 1 1 1 1 2 106 107 106 107 106 107 106 107 106 107 1 1 1 1 1 1 1 2 106 107 106 107 106 107 106 107 106 107 106 107 106 107 106 107 106 107 106 107 106 107 106 107 106 107 106 107 106 107 106 107 106 107 106 107 106 107 106 107 106 107 106 107 112 113 112 113 106 107 112 113 112 113 106 107 106 107 106 107 106 107 106 107 106 107 106 107 54 55 106 107 112 113 112 113 112 113 108 105 108 105 108 105 54 55 108 105 108 105 108 105 108 105 108 105 108 105 54 55 54 55 112 113 112 113 54 55 108 105 108 105 108 105 106 107 106 107 104 105 106 107 112 113 112 113 29 92 93 94 66 103 103 103
1 3 126 127 126 127 126 127 126 127 108 105 108 105 108 105 104 105 108 105 108 105 104 105 27 28 108 105 108 105 27 126 127 126 127 28 108 105 108 105 108 105 108 105 108 105 27 126 1 1 1 1 1 1 1 1 126 126 127 126 127 126 127 126 127 126 1 1 1 1 1 1 1 1 126 126 127 28 108 105 108 105 108 105 108 105 108 105 108 105 108 105 108 105 108 105 27 28 108 105 108 105 108 105 108 105 108 105 108 105 108 105 108 105 108 105 108 105 108 105 108 105 108 105 108 105 108 105 108 105 108 105 108 105 108 105 108 105 108 105 108 105 54 55 108 105 108 105 108 105 108 105 106 107 106 107 106 107 54 55 112 113 106 107 106 107 106 107 106 107 106 107 56 57 54 55 106 107 106 107 54 55 106 107 106 107 106 107 108 105 108 105 106 107 108 105 104 105 104 105 29 96 97 98 66 103 103 103
1 1 1 1 1 1 1 1 1 1 126 127 126 127 126 127 126 127 112 113 112 113 126 127 1 1 126 127 126 127 1 1 1 1 1 1 126 127 112 113 112 113 26 127 126 127 1 1 1 1 1 1 1 1 1 1 1 1 1 1 1 1 1 1 1 1 1 1 1 1 1 1 1 1 1 1 1 1 127 126 127 126 127 126 127 126 112 113 112 113 112 113 127 126 127 126 1 1 126 127 126 127 126 127 126 127 112 113 112 113 112 113 112 113 112 113 112 113 106 107 106 107 106 107 106 107 106 107 106 107 106 107 106 107 106 107 106 107 106 107 106 107 54 55 112 113 106 107 106 107 106 107 108 105 112 113 108 105 54 55 108 105 108 105 108 105 108 105 112 113 112 113 112 113 54 55 108 105 108 105 54 55 108 105 108 105 112 113 112 113 112 113 112 113 112 113 112 113 112 113 112 113 112 100 101 103 103 103
1 1 1 1 1 1 1 1 1 1 1 1 1 1 1 1 1 1 126 127 126 127 1 1 1 1 1 1 1 1 1 1 1 1 1 1 1 1 126 127 126 127 1 1 1 1 1 1 1 1 1 1 1 1 1 1 1 1 1 1 1 1 1 1 1 1 1 1 1 1 1 1 1 1 1 1 1 1 1 1 1 1 1 1 1 1 127 126 127 126 127 126 1 1 1 1 1 1 1 1 1 1 1 1 1 1 126 127 28 105 104 105 104 105 104 105 104 105 108 105 108 105 108 105 108 105 108 105 108 105 108 105 108 105 108 105 108 105 108 105 108 105 54 55 108 105 108 105 108 105 108 105 106 107 106 107 106 107 54 55 106 107 106 107 106 107 106 107 106 107 106 107 106 107 54 55 106 107 106 107 54 55 106 107 106 107 106 107 104 105 104 105 104 105 104 105 104 105 104 105 104 105 104 102 103 103 103 103